Anzahl: 320
adn: and, dan, dna
no: on, no
adis: said, aids
asw: was, saw
as: as, sa
aer: are, era, ear
fmor: from, form
it: it, ti
ahs: has, ash
ist: its, sit
not: not, ton
hist: this, hits
acn: can, anc
emor: more, rome
how: who, how
emos: some, oems
alst: last, salt
eimt: time, item
cdlou: could, cloud
esu: use, sue
eehrt: there, three
os: so, os
now: now, own, won
desu: used, sued
epr: per, rep
eehst: these, sheet
copr: corp, crop
begin: being, begin
egt: get, gte
aestt: state, taste
aems: same, mesa
est: set, est
aprt: part, trap
aeelrsv: several, reveals
aert: rate, tear
efil: file, life
abdes: based, dbase
eiln: line, neil
ersu: user, sure
deos: does, dose
aelst: least, steal
bhsu: bush, hubs
ago: ago, gao
diks: disk, kids
aelry: early, layer, relay
efmorr: former, reform
abdor: board, broad
aerst: rates, tears
ceenrt: recent, center, centre
aelrt: later, alter, alert
adert: trade, rated
degins: design, signed
aelt: late, tale
ans: san, sna
cdeiorrt: director, creditor
eflt: left, felt
aegnr: range, anger
eimst: times, items
aemn: name, mean
ent: net, ten
adeegr: agreed, geared
arw: war, raw
defil: field, filed
adel: deal, lead, dale
aest: east, seat
aenr: near, earn
enrrtu: return, turner
ghinst: things, nights
acm: mac, mca, acm, cam
deno: done, node
aemns: means, names
ags: gas, gsa
lost: lost, lots, slot
aestx: texas, taxes
eilms: miles, smile
ghint: night, thing
aels: sale, seal
adeelrs: leaders, dealers
air: air, ira
ceorsu: source, course
adeelr: leader, dealer
del: led, del
acelnru: nuclear, unclear
eotv: vote, veto
ceorssu: sources, courses
amr: ram, arm, mar
enst: sent, tens
aeimnr: remain, marine
elru: rule, lure
deis: side, esdi
cdeirt: credit, direct
ceeptx: expect, except
ademn: named, amend
delmos: models, seldom
acdeert: created, reacted
elt: let, tel
adegiln: leading, dealing
aekst: takes, stake
aemt: team, meat, mate
ailrt: trial, trail
enost: notes, stone
aeimnrs: remains, marines, seminar
eefl: feel, flee
hortw: worth, throw
epst: step, sept
adei: idea, aide
acesu: cause, sauce
eginor: region, ignore
eginstt: testing, setting
acer: care, race
deirt: tried, tired
flow: flow, wolf
aeilrs: israel, serial
adeelrt: related, altered
ailm: mail, lima
achin: china, chain, icahn
ceinost: section, notices
aeirs: raise, arise
de: de, ed
eist: site, ties
bsu: sub, bus
hp: hp, ph
opst: stop, post, spot, tops
amry: army, mary
adeim: media, aimed
host: shot, host
cot: oct, otc
aeg: age, ega
eiqtu: quite, quiet
aeenrst: eastern, nearest
ceeilnost: elections, selection
acdeilm: medical, claimed
aeht: heat, hate
dens: send, ends
losw: slow, lows
aelnp: panel, plane
psu: sup, ups
aegst: stage, gates
acdeinotu: education, cautioned
gins: sign, sing
aehrt: heart, earth
ddeein: denied, indeed
ainr: iran, rain
eenstv: events, steven
aegllry: largely, gallery
cdeinortu: reduction, introduce
aehps: phase, shape
abekr: break, baker
eortw: wrote, tower
cdeiorrst: directors, creditors
am: am, ma
enos: ones, nose
gnorw: wrong, grown
enot: note, tone
aeegr: agree, eager
hstu: thus, shut
aceinort: reaction, creation
aefr: fear, fare
acost: coast, costa
acilopt: optical, capitol
nor: nor, ron
elos: lose, sole
nosw: owns, snow
ceeilns: license, silence
aiprs: paris, pairs
aekw: weak, wake
msv: vms, mvs
ghotu: tough, ought
aesst: seats, asset
cpu: cpu, cup
eeerrsv: reserve, reverse
adels: deals, leads
ac: ca, ac
cd: dc, cd
abelst: tables, stable
oprst: ports, sport
ceenrst: centers, centres
abenry: nearby, barney
adenrw: warned, andrew
definr: friend, finder
adeis: ideas, aside, aides
gm: gm, mg
deeginrs: resigned, designer
ademr: armed, dream
acep: pace, cape
aelnps: planes, panels
befir: brief, fiber
aefrs: fears, fares, safer
arst: star, arts, rats
agiinrs: raising, arising
deeirsv: revised, diverse
eortu: route, outer
adrw: draw, ward
ads: ads, sad
aekl: lake, leak
al: la, al
acinotu: auction, caution
aabdor: aboard, abroad
cdeiinoprst: description, predictions
ckrstu: struck, trucks
irs: sir, irs, sri
el: el, le
dei: die, edi
acers: acres, races
ios: osi, iso
cnr: ncr, nrc
abet: beat, beta
eefgiln: feeling, fleeing
acpt: pact, capt
eerst: trees, reset
deit: tied, edit, diet, tide
aemrst: master, stream
aemst: teams, steam
cddeeirt: directed, credited
acst: cast, acts
aes: sea, esa
adegnr: danger, ranged, garden
cdeeilns: declines, licensed
adesty: steady, stayed
aerr: rare, rear
cdeinorstu: reductions, introduces
loop: pool, loop
ceersu: secure, rescue
ilos: soil, oils
bsuy: busy, buys
bdenru: burden, burned
deeinrst: resident, inserted
aim: aim, ami
adlnor: ronald, arnold
adil: laid, dial
dgo: god, dog
aenrrw: warner, warren
abinr: brain, brian
ap: ap, pa
agry: gary, gray
acmors: macros, marcos
eeirsvw: reviews, viewers
ceop: opec, cope
eiimnoprss: permission, impression
acns: scan, cans
eforst: forest, foster
epstu: setup, upset
orty: troy, tory
eirsst: sister, resist
deeirs: desire, reside
einoprt: pointer, protein
ghilst: slight, lights
aelm: male, meal
deistu: duties, suited
aailmn: animal, manila
acellr: recall, caller
adelt: delta, dealt
aepst: tapes, paste
aet: eat, tea
det: edt, ted
cdeersu: reduces, secured, rescued
ag: ag, ga
aeeilnpst: penalties, palestine
acdeelr: cleared, declare
coprs: crops, corps
enops: opens, epson
epru: pure, peru
ast: sat, ast
eginrs: resign, singer, ingres
blow: blow, bowl
aaglno: analog, angola
opsst: posts, spots, stops
inprst: prints, sprint
aelp: plea, leap
eghhit: height, eighth
eirst: tries, tires
hosst: shots, hosts
iprst: strip, trips
acellrs: recalls, callers
ahsw: wash, shaw
cloo: cool, colo
aceinnoorstv: conservation, conversation
cdeent: decnet, decent
ainrst: strain, trains
ceir: rice, eric
ggiinns: signing, singing
ciopt: topic, optic
aehpss: phases, shapes
acert: trace, react
abt: tab, bat
deeerrsv: reversed, reserved
deiinoopst: deposition, positioned
cos: sco, cos
ipt: tip, pit
rs: rs, sr
apt: pat, tap
adeels: leased, sealed
aegilnrt: relating, integral
efghirt: fighter, freight
adelst: slated, lasted
eilnst: listen, silent
aeln: lane, lean
ehors: horse, shore
alloy: loyal, alloy
des: eds, des
ipst: tips, pits
acorst: actors, castro
ddo: odd, dod
acprs: sparc, scrap
giinrv: irving, virgin
ginorst: storing, sorting
akprs: parks, spark
ginsw: swing, wings
beinrtu: turbine, tribune
ci: ic, ci
aejn: jane, jean
adp: pad, adp
aabcdkrw: drawback, backward
aekls: lakes, leaks
eekn: keen, knee
cddeinostu: discounted, deductions
aclor: carol, carlo
anps: span, snap
eosw: owes, woes
loops: pools, loops
