Anzahl: 237
der: der, red
des: des, sed
im: im, mi
ein: ein, nie
als: als, las
an: an, na
asu: aus, usa
eis: sie, sei, eis
eeinr: einer, reine, irene
eeimn: einem, meine
eins: sein, eins
eeins: seine, eines, seien, eisen
ehir: ihre, hier
eeinrs: seiner, reisen
aegst: sagte, tages
denruw: wurden, wunder
ad: da, ad
ab: ab, ba
eenrst: ersten, sterne
ehinr: ihren, rhein
deerw: werde, weder
agst: sagt, gast
hin: ihn, hin
eeimns: seinem, meines
erst: erst, rest
eikn: kein, knie
acehmn: machen, manche
eilv: viel, live
dps: spd, pds
deenn: denen, enden
beeln: leben, nebel
eknnot: konnte, konten, knoten
eehnst: stehen, thesen
deenr: deren, reden
eerst: erste, reste
agr: gar, arg
eegnrst: gestern, strenge
achmt: macht, match
abeirt: arbeit, beirat
aegln: lange, lagen, nagel
erw: wer, rwe
art: art, rat
bbeeiln: bleiben, blieben
eehr: eher, ehre, heer
aeiprt: partei, partie
beenos: ebenso, soeben
aegnt: tagen, getan
aegnu: genau, augen
cehirs: sicher, schier
efhnrü: führen, frühen
aegl: lage, egal
ehiß: hieß, heiß
acdehmn: nachdem, demnach
eenrtu: erneut, teuren
eelnrt: eltern, lernte
aeinrrt: trainer, terrain
aklr: klar, karl
eeinst: seiten, steine
eiltt: titel, teilt
bbeil: blieb, bibel
abeeinrt: arbeiten, anbieter
eeisw: weise, wiese
efhrrü: früher, führer
eeiltt: teilte, leitet
beeirt: bereit, breite
deikrt: direkt, kredit
eikrs: kreis, krise
adehln: handel, handle
efir: frei, rief
abden: abend, bande, baden
eeginnw: wenigen, gewinne
eeimnt: meinte, mieten
ort: ort, tor, rot
aeiknt: aktien, antike
eeginw: wenige, ewigen
chist: sicht, tisch, stich
esstt: stets, tests
cdeeehinnst: entschieden, entscheiden
eeglnt: gelten, legten
deer: rede, erde
aegnrt: tragen, garten
alt: alt, tal
fltu: luft, flut
einst: einst, stein
eefhln: helfen, fehlen
eilst: liste, liest, teils
ceehinrst: erscheint, scheitern, streichen
eegnr: gerne, regen, enger
ehitz: zieht, hitze
aemt: team, atem
egist: stieg, geist
eefhlr: fehler, helfer
ceeehinnrs: erschienen, erscheinen
efil: fiel, lief
eegln: legen, engel
bcehsu: besuch, buches
ceehnrt: rechnet, rechten
aenrtw: warten, warnte
ehorrv: vorher, hervor
dennor: norden, ordnen
eeirs: reise, serie
eeginst: steigen, stiegen
eeilt: teile, elite
beelns: lebens, selben
ceehilnstw: wesentlich, westlichen
adr: dar, ard, rad
aeklss: klasse, kassel
eegilpst: gespielt, spiegelt
eeglt: legte, gelte
eenrtt: treten, retten
aaegln: anlage, angela
eefinr: freien, feiern, ferien, reifen, riefen
einw: wien, wein
acfhls: falsch, schlaf
ehlot: hotel, holte
aeeglnr: anleger, general
eehst: stehe, these
deeilr: leider, lieder, derlei
eeeginr: eigener, energie
eeeggilnt: gegenteil, eingelegt
cefhirs: fischer, frische
egilntu: leitung, teilung
eehhnrö: höheren, erhöhen
cehins: schien, schein
eeilz: ziele, zeile
enrst: ernst, stern
deein: ideen, deine
ceehlsw: wechsel, welches
egistt: steigt, stetig
dfor: dorf, ford
ceehinns: scheinen, chinesen, schienen
egjnrü: jürgen, jünger
ceehrt: rechte, echter
eertu: teuer, teure, treue
eefir: freie, feier
efgirt: fertig, greift
aceghlns: schlagen, schlange
eeinrtv: vierten, vereint
deeeimnrv: vermeiden, vermieden
eort: tore, rote, orte
eeilnt: teilen, leiten
cceehhinst: technische, tschechien
ceeghirst: gesichert, gesichter
amrtu: traum, armut
enort: roten, orten, toren, tenor
aeiknort: reaktion, kroatien
egn: eng, gen
ekruz: kurze, kreuz
not: ton, not
ceehinrs: erschien, sicheren
achiinrst: christian, christina
aeglmn: langem, mangel
beeglt: belegt, gelebt
bbceeehinrs: beschrieben, beschreiben
eguz: zuge, zeug
beeisw: beweis, bewies
defnrrö: fördern, dörfern
eerttw: wetter, wertet
eefiln: fielen, liefen
aeeggnrt: getragen, angeregt
deost: desto, todes
bbeeil: bleibe, bliebe
eikln: klein, linke
eegiinrs: ereignis, riesigen
eerrtu: reuter, teurer
adeln: lande, laden
aemnns: mannes, namens
beeeinsw: beweisen, bewiesen
acefhlns: falschen, flaschen, schlafen
acefhls: falsche, flasche
aenrt: arten, raten
bbeeeinrt: betreiben, betrieben
eeinsw: weisen, wiesen
eefirt: feiert, tiefer
eegiinst: einstieg, einstige
cehir: reich, erich
eglnä: länge, lägen
aemst: teams, amtes
abdeglr: belgrad, bargeld
beirt: breit, trieb
begrtu: betrug, geburt
adeilmr: dreimal, daimler
eeeinrsw: erwiesen, erweisen
emrtuä: räumte, träume
deefnnru: freunden, erfunden
adnr: rand, dran
aefhn: hafen, fahne
beeinrt: breiten, treiben
beirtt: treibt, bitter
eeinnr: innere, reinen
defin: finde, feind
eenrt: rente, ernte
ceehilt: leichte, etliche
ost: ost, ots
aeglnr: langer, lagern
deeikrt: kredite, direkte
ccehhinst: technisch, schichten
eeilnz: zeilen, zielen
egrrtä: träger, ärgert
eegins: eigens, siegen
eeilmnrtt: mittleren, ermitteln
eegn: enge, gene
ceehilnt: leichten, teilchen
aentt: taten, tante
fglo: golf, flog
deil: lied, leid
eefghlno: geholfen, geflohen
efhrü: führe, frühe
ceehil: leiche, eichel
ceeghirt: gerichte, gereicht
beeeinrrtv: vertrieben, vertreiben, verbreiten
eeeinrsvw: verwiesen, verweisen
beegl: beleg, gelbe
eeehilnrv: verliehen, verleihen
beeginrrtuv: verbreitung, vertreibung
behrtu: beruht, hubert
aenrtt: traten, ratten
aeeegginnrt: eingetragen, engagierten
adlnor: roland, arnold
enw: new, wen
en: en, ne
beeegilnt: begleiten, geliebten
deklnu: dunkle, dunkel
cfhsu: schuf, fuchs
ceehnrsstw: schwestern, schwersten
ennot: noten, tonne
beel: elbe, lebe
aehnn: nahen, ahnen
bceehins: schieben, scheiben
beemnrs: bremsen, bremens
ceghilos: sogleich, logische
aejn: jena, jean
dou: duo, udo
benot: beton, boten
abeeeinrrtv: vereinbarte, verarbeiten
eeprs: spree, peres
ehnru: ruhen, uhren
